3 3 3 3 3 3 3 3 3 3 3 3 3 3 3 3 3 3 3 3 3 3 3 3 3 3 3 3 3 3 3 3 3 3 3 3 3 3 3 3 3 3 3 3 3 3 3 3 3 3
3 3 3 3 3 3 3 3 3 3 3 3 3 3 3 3 3 3 3 3 3 3 3 3 3 3 3 3 3 3 3 3 3 3 3 3 3 3 3 3 3 3 1 1 1 1 1 3 3 3
3 3 3 3 3 3 3 3 3 3 3 3 3 3 3 3 3 3 3 3 3 3 3 3 3 3 3 3 3 3 3 3 3 3 3 3 3 3 3 3 3 1 1 3 1 3 1 1 3 3
3 3 3 3 3 3 3 3 3 3 3 3 3 3 3 3 3 3 3 3 3 3 3 3 3 3 3 3 3 3 3 3 3 3 3 3 3 3 3 3 3 1 3 3 1 3 3 1 3 3
3 3 3 3 3 3 3 3 3 3 3 3 3 3 3 3 3 3 3 3 3 3 3 3 3 3 3 3 3 3 3 3 3 3 3 3 3 3 3 3 3 1 3 3 1 3 3 1 3 3
3 3 3 3 3 3 3 3 3 3 3 3 3 3 3 3 3 3 3 3 3 3 1 3 3 3 3 3 3 3 3 3 3 3 3 3 3 3 3 3 3 1 1 3 1 1 3 1 3 3
3 3 3 3 3 3 3 3 3 3 3 3 3 3 3 3 3 3 3 3 3 3 3 3 3 3 3 3 3 3 3 3 3 3 3 3 3 3 3 3 3 3 1 3 3 3 3 1 3 3
3 3 3 3 3 3 3 3 3 3 1 1 1 3 3 3 3 3 3 3 3 3 1 1 1 1 1 1 3 3 3 3 3 3 3 3 3 3 3 3 3 3 1 1 1 1 1 1 3 3
3 3 3 3 3 3 3 3 1 1 1 1 1 1 3 3 3 3 3 3 3 1 9 8 8 8 8 8 10 3 3 3 3 3 3 3 3 3 3 3 3 3 3 1 1 1 1 3 3 3
3 3 3 3 3 1 1 1 1 1 1 1 3 3 1 3 3 3 3 3 3 9 5 5 5 5 5 5 7 1 3 3 3 3 3 3 3 3 3 3 3 3 3 3 2 3 3 3 3 3
3 3 3 3 1 1 1 3 1 1 3 1 1 3 1 1 3 3 3 3 3 6 5 5 5 5 5 5 5 10 3 3 3 3 3 3 3 3 3 3 3 3 3 3 2 3 3 3 3 3
3 3 3 1 1 1 1 1 1 3 1 1 1 1 3 1 3 3 3 3 3 6 5 5 5 5 5 5 5 7 3 3 3 3 3 3 3 3 3 3 3 3 3 3 2 3 3 3 3 3
3 3 3 1 3 1 1 1 3 1 1 3 3 1 3 1 3 3 3 3 3 6 5 5 5 5 5 5 5 3 3 3 3 3 3 3 3 3 3 3 3 3 3 3 2 3 3 3 3 3
3 3 1 1 3 1 1 1 3 1 3 3 3 1 3 1 3 3 3 3 1 1 5 5 5 5 5 5 5 3 3 3 3 3 3 3 3 3 3 3 3 3 3 3 2 3 3 3 3 3
3 3 1 3 1 1 1 3 3 3 1 1 1 1 3 1 3 3 3 3 1 1 1 1 1 1 1 1 1 1 3 3 3 3 3 3 3 3 3 3 3 3 3 3 2 3 3 3 3 3
3 3 1 1 1 1 1 3 3 1 1 1 1 3 1 1 3 3 3 3 3 1 1 1 1 1 1 1 1 1 3 3 3 3 3 3 3 3 3 3 3 3 3 3 2 3 3 3 3 3
3 3 3 1 1 1 1 1 1 1 1 3 3 1 1 3 3 3 3 3 3 3 1 1 1 1 1 1 1 3 3 3 3 3 3 3 3 3 3 3 3 3 3 3 2 3 3 3 3 3
3 3 3 1 1 1 1 3 3 3 1 1 1 1 3 3 3 3 3 3 3 3 3 3 2 3 3 3 3 3 3 3 3 3 3 3 3 3 3 3 3 3 3 3 2 3 3 3 3 3
3 3 3 3 1 1 1 1 1 1 1 1 1 1 3 3 3 3 3 3 3 3 3 3 2 3 3 3 3 3 3 3 3 3 3 3 3 3 3 3 3 3 3 3 2 3 3 3 3 3
3 3 3 3 3 3 1 1 1 1 1 3 3 2 3 3 3 3 3 3 3 3 3 3 2 3 3 3 3 3 3 3 3 3 3 3 3 3 3 3 3 2 2 2 2 2 2 3 3 3
3 3 3 3 3 3 3 3 3 3 3 3 3 2 3 3 3 3 3 3 3 3 3 3 2 3 3 3 3 3 3 3 3 3 3 3 3 3 3 3 3 3 3 3 3 3 2 2 3 3
3 3 3 3 3 3 3 3 3 3 3 3 3 2 3 3 3 3 3 3 3 3 3 3 2 3 3 3 3 3 3 3 3 3 3 3 3 3 3 3 3 3 3 3 3 3 3 2 3 3
3 3 3 3 3 3 3 3 3 3 3 3 3 2 3 3 3 3 3 3 3 3 3 3 2 3 3 3 3 3 3 3 3 3 3 3 3 3 3 3 3 3 3 3 3 3 3 2 3 3
3 3 3 3 3 3 3 3 3 3 3 3 3 2 3 3 3 3 3 3 3 3 3 3 2 3 3 3 3 3 3 3 3 3 3 3 3 3 3 3 3 3 3 3 3 3 3 2 3 3
3 3 3 3 3 3 3 3 3 3 3 3 3 2 3 3 3 3 3 3 3 3 3 3 2 3 3 3 3 3 3 3 3 3 3 3 3 3 3 3 3 3 3 3 3 3 3 2 3 3
3 3 3 3 3 3 3 3 3 3 3 3 3 2 3 3 3 3 3 3 3 3 3 3 2 3 3 3 3 3 3 3 3 3 3 3 3 3 3 3 3 3 3 3 3 3 3 2 3 3
3 3 3 3 3 3 3 3 3 3 3 3 3 2 3 3 3 3 3 3 3 3 3 3 2 3 3 3 3 3 3 3 3 3 3 3 3 3 3 3 3 3 3 3 3 3 3 2 3 3
3 3 3 3 3 3 3 3 3 3 3 3 3 2 3 3 3 3 3 3 3 3 3 3 2 3 3 3 3 3 3 3 3 3 3 3 3 3 3 3 3 3 3 3 3 2 2 2 3 3
3 3 3 3 4 4 4 4 4 4 4 3 3 2 3 3 3 3 3 1 1 1 1 1 2 1 1 1 1 3 3 3 3 3 3 3 3 3 3 3 3 3 3 2 2 2 3 3 3 3
3 3 3 3 4 0 0 0 0 0 4 3 3 2 3 3 3 1 1 1 1 1 1 1 2 1 1 1 1 1 3 3 3 3 3 3 3 3 3 3 3 3 2 2 3 3 3 3 3 3
3 3 3 3 4 0 0 0 0 0 4 3 3 2 3 3 3 1 1 1 1 1 1 1 2 1 1 1 1 1 1 3 3 3 3 3 3 3 3 3 3 2 2 3 3 3 3 3 3 3
3 3 3 3 4 0 0 0 0 0 4 3 3 2 3 3 3 1 1 1 1 1 1 1 2 1 1 1 1 1 1 1 3 3 3 3 3 3 3 3 3 2 3 3 3 3 3 3 3 3
3 3 3 3 4 4 4 0 4 4 4 3 3 2 3 3 3 1 1 1 1 1 1 1 2 1 1 1 1 1 1 1 3 3 3 3 3 3 3 3 3 2 2 2 2 2 2 3 3 3
3 3 3 3 3 3 3 2 3 3 3 3 3 2 3 3 3 1 1 1 1 1 1 1 2 1 1 1 1 1 1 1 3 3 3 3 3 3 3 3 2 2 3 3 3 3 2 3 3 3
3 3 3 3 3 3 3 2 3 3 3 3 3 2 2 2 2 2 2 2 2 2 2 2 2 2 2 2 2 2 2 2 2 2 2 2 2 2 2 2 2 3 3 3 3 3 2 3 3 3
3 3 3 3 3 3 3 2 3 3 3 3 3 3 3 3 3 1 1 1 1 1 1 1 2 1 1 1 1 1 1 1 3 3 3 3 3 3 3 3 3 3 3 3 3 3 2 3 3 3
3 3 3 3 3 3 3 2 3 3 3 3 3 3 3 3 3 1 1 1 1 1 1 1 2 1 1 1 1 1 1 1 3 3 3 3 3 3 3 3 3 3 3 3 3 3 2 3 3 3
3 3 3 3 3 3 3 2 3 3 3 3 3 3 3 3 3 3 1 1 1 1 1 1 2 1 1 1 1 1 1 3 3 3 3 3 3 3 3 3 3 3 3 3 3 3 2 3 3 3
3 3 3 3 3 3 3 2 3 3 3 3 3 3 3 3 3 3 3 1 1 1 1 1 2 1 1 1 1 1 3 3 3 3 3 3 3 3 2 2 2 2 2 2 2 2 2 3 3 3
3 3 3 3 3 2 2 2 3 3 3 3 3 3 3 3 3 3 3 3 1 1 1 1 2 1 1 1 1 3 3 3 3 3 3 3 3 3 2 3 3 3 3 2 3 3 2 3 3 3
3 3 3 3 3 2 3 3 3 3 3 3 3 3 3 3 3 3 3 3 3 3 3 3 2 3 3 3 3 3 3 3 3 3 2 2 2 2 2 2 2 3 3 2 3 3 2 3 3 3
3 3 3 3 3 2 3 3 3 3 3 3 3 3 3 3 3 3 3 3 3 3 3 3 2 3 3 3 3 3 3 3 3 3 2 3 3 3 3 3 2 2 2 2 2 2 2 3 3 3
3 3 3 3 3 2 2 2 2 2 2 2 2 2 2 2 2 2 2 2 2 2 2 2 2 3 3 3 2 2 2 2 2 2 2 3 3 3 3 3 2 3 3 2 3 3 2 3 3 3
3 3 3 3 3 3 3 3 3 3 3 3 3 3 3 3 3 3 3 3 3 3 3 3 3 3 3 3 2 3 3 3 3 3 2 3 3 3 3 2 2 3 3 2 3 3 2 3 3 3
3 3 3 3 3 3 3 3 3 3 3 3 3 3 3 3 3 3 3 3 3 3 3 3 3 3 3 3 2 3 3 3 3 3 2 3 3 3 3 2 3 3 3 2 3 3 2 3 3 3
3 3 3 3 3 3 3 3 3 3 3 3 3 3 3 3 3 3 3 3 3 3 3 3 3 3 3 3 2 3 2 2 2 2 2 2 2 2 2 2 3 3 3 2 2 2 2 3 3 3
3 3 3 3 3 3 3 3 3 3 3 3 3 3 3 3 3 3 3 3 3 3 3 3 3 3 3 3 2 3 2 3 3 3 2 3 3 3 3 2 3 3 3 2 3 3 2 3 3 3
3 3 3 3 3 3 3 3 3 3 3 3 3 3 3 3 3 3 3 3 3 3 3 3 3 3 3 3 2 3 2 3 3 3 2 3 3 3 3 2 3 3 3 2 3 3 2 3 3 3
3 3 3 3 3 3 3 3 3 3 3 3 3 3 3 3 3 3 3 3 3 3 3 3 3 3 3 3 2 2 2 2 2 2 2 2 2 2 2 2 2 2 2 2 2 2 2 3 3 3
3 3 3 3 3 3 3 3 3 3 3 3 3 3 3 3 3 3 3 3 3 3 3 3 3 3 3 3 3 3 3 3 3 3 3 3 3 3 3 3 3 3 3 3 3 3 3 3 3 3