19 18 18 18 18 18 18 18 18 18 18 18 18 18 18 18 18 18 18 18 18 18 18 18 18 18 18 18 19 18 18 18 18 18 18 18 18 18 19 18 18 18 18 18 18 18 18 18 18 18 
18 19 18 19 19 18 18 18 18 19 19 18 18 18 18 19 18 18 18 18 18 19 18 18 18 18 18 18 18 18 18 18 18 18 18 18 18 18 18 18 18 28 26 26 26 26 26 29 19 18 
18 18 18 18 18 18 18 18 19 18 18 18 18 18 18 18 18 18 18 18 18 18 19 18 18 18 18 18 18 18 18 18 18 19 18 18 18 18 18 18 28 27 1 1 1 1 1 23 18 18 
18 18 18 19 18 18 18 19 19 18 18 18 19 19 18 18 18 18 18 19 18 18 19 18 18 18 18 19 18 18 18 18 18 18 19 18 18 18 18 28 27 1 1 32 32 32 32 25 29 19 
18 18 18 19 18 18 18 18 18 18 18 18 18 18 18 18 18 18 18 18 18 18 18 18 18 18 18 18 18 18 18 18 18 18 19 18 18 18 28 27 1 1 16 32 1 36 32 1 23 18 
18 19 18 18 18 19 18 18 18 18 18 18 18 18 19 18 18 18 18 19 18 18 18 18 19 19 19 18 18 18 19 18 18 18 18 18 18 18 24 1 32 32 32 32 1 1 32 1 23 18 
18 18 18 18 18 18 18 18 18 18 18 19 18 18 18 18 18 28 26 26 26 26 26 29 18 18 18 18 28 26 26 26 29 18 18 18 18 18 24 1 32 2 2 2 1 1 32 1 23 18 
18 18 18 18 18 18 19 19 18 28 26 26 26 26 26 26 26 27 1 1 1 1 1 25 26 26 26 26 27 1 1 1 25 29 18 18 18 18 24 1 32 32 32 1 32 1 32 1 23 18 
18 18 18 18 18 18 18 28 26 27 1 1 1 1 1 1 1 1 1 1 16 36 1 1 1 1 1 1 1 1 1 1 1 25 29 19 18 18 30 22 1 1 16 1 32 32 32 1 23 18 
18 19 19 18 18 28 26 27 1 1 1 1 1 1 1 1 2 1 32 32 32 32 32 32 32 32 1 1 16 1 1 1 1 1 23 18 18 18 18 30 22 1 1 1 2 1 1 1 23 18 
18 18 18 18 18 24 1 1 1 16 1 1 1 1 2 2 2 1 32 17 17 1 1 2 16 32 1 1 1 1 16 1 1 1 25 29 18 19 19 18 30 22 1 1 2 1 1 20 31 18 
18 18 18 18 18 24 1 1 1 1 1 1 1 1 1 2 2 1 32 36 17 1 33 1 2 32 1 1 1 1 1 1 1 1 1 25 29 18 18 18 18 30 21 21 21 21 21 31 18 18 
18 18 19 18 28 27 1 1 1 1 2 1 1 1 1 1 1 1 32 17 17 1 2 1 1 32 2 1 1 1 1 1 1 1 1 1 25 26 29 18 18 18 18 18 18 18 18 18 18 18 
18 18 19 18 24 1 1 1 1 1 2 1 1 16 1 1 1 1 32 32 32 12 10 32 32 32 1 1 1 1 1 1 1 1 1 1 1 1 23 18 18 18 18 19 18 18 18 18 18 18 
18 18 18 18 24 1 1 36 1 1 1 1 1 1 1 1 1 1 1 1 1 8 3 7 2 1 1 1 1 16 1 1 1 1 16 1 1 1 25 29 18 18 18 19 18 18 19 18 18 18 
18 19 19 18 24 1 1 1 1 1 1 16 1 1 1 1 1 1 1 1 1 8 3 9 10 10 10 10 13 1 1 1 1 1 1 1 2 1 1 23 18 18 18 18 18 18 18 18 18 18 
18 18 18 18 30 22 1 1 1 1 1 1 16 1 1 1 1 16 1 1 1 8 3 3 3 3 3 3 7 1 1 1 1 1 1 1 1 1 1 25 29 18 18 18 18 18 18 19 18 18 
18 18 18 18 18 30 22 1 1 2 16 1 1 2 1 1 1 1 1 1 1 14 5 5 5 5 6 3 7 1 1 1 1 1 1 1 1 1 1 1 23 18 18 18 18 18 18 18 18 18 
18 18 18 19 18 18 24 1 1 2 1 1 1 1 1 1 1 1 1 1 1 1 1 16 1 1 8 3 7 1 1 1 16 1 1 16 1 1 1 1 23 18 18 18 18 18 18 18 18 18 
18 18 18 18 18 18 24 1 1 2 1 1 1 1 1 2 1 2 2 1 1 1 1 1 1 1 8 3 7 1 1 1 1 1 1 1 1 1 1 1 23 18 18 19 18 18 18 18 18 18 
18 18 19 18 18 18 24 2 1 1 1 1 1 1 1 1 1 1 1 1 1 1 1 1 1 1 8 3 7 1 1 1 1 1 1 2 2 2 1 1 23 18 18 19 19 18 18 18 18 18 
18 18 18 18 18 18 24 1 1 1 1 1 1 1 1 1 1 2 2 1 1 1 1 1 1 1 8 3 7 1 1 1 1 16 1 1 1 1 1 1 23 18 18 18 18 18 19 18 18 18 
18 18 18 18 19 18 24 1 2 1 16 1 1 1 16 1 1 1 2 1 1 1 1 1 1 1 8 3 7 1 16 1 1 1 2 2 1 1 1 20 31 18 19 18 18 18 18 18 18 18 
18 18 18 18 19 18 24 1 1 1 1 1 1 1 1 1 1 1 1 1 1 1 1 1 1 1 8 3 7 1 1 1 1 1 2 1 16 1 1 23 18 18 18 18 18 18 18 18 19 18 
18 18 19 18 18 18 24 1 1 1 1 1 1 1 1 1 1 1 1 1 1 1 16 1 1 1 8 3 7 1 1 1 1 1 1 1 1 1 1 23 18 18 18 18 18 18 18 18 18 18 
18 18 18 19 18 19 24 1 1 1 1 1 1 1 1 1 1 16 1 1 1 1 1 1 1 1 8 3 7 1 1 1 1 1 2 1 1 1 1 23 18 18 19 18 19 18 18 18 18 18 
18 18 18 19 18 18 30 22 1 2 1 1 1 1 1 1 1 1 1 1 1 1 1 1 16 1 8 3 7 1 1 1 16 1 1 1 1 1 1 25 29 18 19 18 18 18 19 18 18 18 
18 18 18 18 18 18 18 24 1 1 1 1 1 1 1 1 1 1 1 1 1 1 1 1 12 10 11 3 7 1 16 1 1 1 1 1 16 1 1 1 25 29 18 18 19 18 18 18 18 18 
18 18 19 18 19 18 18 24 1 1 1 1 16 12 10 10 10 10 10 13 16 1 1 1 8 3 3 3 7 1 1 1 1 1 1 1 1 1 1 1 1 23 18 18 18 18 18 18 18 18 
18 18 18 18 18 18 18 24 1 1 1 16 1 8 3 3 3 3 3 7 1 1 1 1 8 3 4 5 15 1 1 16 1 1 1 1 1 1 1 1 1 25 26 29 18 18 18 18 19 18 
18 18 18 18 18 18 18 24 1 2 1 1 1 8 3 4 5 6 3 9 10 10 10 10 11 3 7 1 1 1 1 1 1 1 16 1 1 1 1 2 1 1 1 25 26 29 18 18 18 18 
19 18 19 19 18 19 18 24 1 1 1 1 1 8 3 7 1 8 3 3 3 3 3 3 3 3 7 1 16 1 1 16 1 1 1 1 1 2 1 1 1 1 2 1 1 25 29 18 18 19 
18 18 18 18 18 18 18 24 1 1 2 1 1 8 3 7 16 14 5 5 5 5 5 5 5 5 15 1 1 1 1 1 1 1 1 1 1 1 1 1 1 1 2 1 1 1 23 19 19 18 
18 18 28 26 26 26 29 24 1 1 1 1 1 8 3 7 1 1 1 1 1 2 1 1 1 1 1 1 1 1 1 2 1 1 2 1 1 1 1 20 22 1 1 1 1 1 23 18 18 18 
18 28 27 1 1 1 23 30 22 1 1 1 2 8 3 7 1 1 1 1 1 1 1 20 21 21 22 1 1 1 1 1 1 1 1 1 1 1 20 31 30 21 22 1 2 1 23 19 18 18 
28 27 1 1 1 1 25 29 30 21 22 1 1 8 3 7 1 1 1 1 1 20 21 31 18 18 30 21 21 21 22 1 1 20 21 21 21 21 31 18 18 18 24 1 2 1 23 18 19 19 
24 1 1 16 1 1 1 25 26 29 30 22 1 14 5 15 1 1 1 1 20 31 18 18 18 18 18 18 18 18 30 21 21 31 18 18 18 18 18 18 18 18 24 1 1 1 23 18 18 18 
24 1 1 1 1 2 1 1 1 25 29 30 22 1 1 1 1 1 20 21 31 18 18 18 18 19 18 18 18 18 18 18 18 18 18 18 19 18 18 18 19 18 24 1 1 2 23 18 18 18 
30 22 1 1 1 1 2 1 1 1 25 26 27 1 1 1 1 20 31 18 18 18 18 18 18 18 18 18 18 18 19 18 18 18 18 18 18 18 19 18 18 28 27 1 1 1 23 18 19 18 
18 24 1 2 1 1 1 2 2 1 1 1 1 2 1 1 20 31 18 19 18 18 18 19 18 18 18 28 26 26 26 26 26 26 29 18 18 18 18 18 28 27 1 1 1 20 31 18 18 18 
18 30 22 1 1 2 1 1 1 1 1 1 1 1 1 20 31 18 18 19 18 18 18 18 18 28 26 27 1 1 1 1 1 1 25 26 29 18 18 28 27 1 2 1 1 23 18 18 18 18 
18 18 24 1 1 1 1 1 1 1 1 1 2 1 1 23 18 18 18 18 19 18 19 18 18 24 1 1 1 1 1 16 1 1 1 1 25 26 26 27 1 2 2 1 20 31 18 18 18 18 
18 18 30 22 1 1 1 1 16 2 1 1 1 1 20 31 18 18 18 18 18 18 18 18 28 27 1 1 1 1 1 1 1 1 1 1 1 1 1 1 1 1 20 21 31 18 18 18 18 19 
18 18 18 30 21 22 1 1 1 1 1 1 20 21 31 18 18 18 18 18 19 18 18 18 24 1 1 2 2 1 1 1 1 2 1 1 1 1 2 1 20 21 31 18 18 18 18 18 18 18 
18 19 19 18 18 30 21 21 21 21 21 21 31 18 18 18 18 19 18 18 19 18 18 28 27 1 1 1 1 1 2 2 1 1 1 1 1 16 1 1 23 18 18 18 18 19 18 18 18 18 
18 19 19 18 18 18 18 18 18 18 18 18 18 18 18 18 18 18 18 18 18 18 18 24 1 1 2 1 2 1 1 1 1 1 1 2 1 1 1 1 23 18 18 18 18 19 18 18 18 18 
18 18 18 19 18 18 18 19 18 18 18 18 18 18 19 18 18 18 18 18 18 19 18 24 1 1 16 1 1 1 1 1 1 1 1 1 1 1 1 20 31 19 18 18 18 18 18 18 18 19 
18 18 18 19 18 18 18 18 18 18 18 18 18 18 18 18 18 19 18 18 19 18 18 24 1 1 1 1 1 1 1 16 1 1 2 1 1 1 1 23 18 18 18 19 18 18 19 18 18 18 
19 19 18 19 18 18 19 18 18 18 18 19 18 18 19 19 19 18 18 18 18 18 18 30 22 1 1 1 1 1 1 1 1 1 1 1 1 1 20 31 18 18 18 18 18 19 18 18 19 18 
19 18 18 18 18 18 18 18 18 18 19 19 18 18 18 18 18 18 18 18 18 18 19 18 30 21 21 22 1 1 20 21 22 1 1 1 20 21 31 18 18 18 18 18 18 18 18 18 18 18 
